“罗斯福”号航母	ship
“罗斯福”号	ship
“罗斯福号”航母	ship
CVN71“罗斯福”号	ship
“西奥多·罗斯福”号航母	ship
罗斯福号	ship
“罗斯福”	ship
“富兰克林-D-罗斯福”号	ship
“罗斯福”号航母战斗群	ship
罗斯福号航空母舰	ship
“罗斯福”号航母舰	ship
“罗斯福”号航母(CVN 71)	 ship
CVN71罗斯福号航母	ship
“罗斯福”号(CVN 71) 	ship
“罗斯福”号航空母舰	ship
“西奥多·罗斯福”号航空母舰	ship
“罗斯福号”	ship
美国海军罗斯福号核动力航母	ship
“西奥多·罗斯福”号(CVN－71) 	ship
罗斯福号航空母舰	ship
“杜鲁门”号航母	ship
“杜鲁门”号	ship
“杜鲁门”号航母战斗群	ship
“哈里·杜鲁门”号航母	ship
“杜鲁门”号航空母舰	ship
CVN75“杜鲁门”号	ship
“哈里·杜鲁门”号核动力航母	ship
杜鲁门号航空母舰	ship
“杜鲁门”号核动力航母	ship
‘杜鲁门’号航母	ship
杜鲁门号	ship
“杜鲁门”	ship
“杜鲁门”号航母打击大队	ship
“杜鲁门”号舰	ship
美国海军“杜鲁门”号(CVN 75)航母战斗群	ship
杜鲁门号航母	ship
美国海军“杜鲁门”号航母	ship
“哈里·S·杜鲁门”号核动力航空母舰	ship
“杜鲁门”号核航母	ship
“杜鲁门“号航母	ship
美国杜鲁门号核动力航母	ship
美国海军“杜鲁门”号航母战斗群	ship
尼米兹”级航母“杜鲁门”号	ship
“杜鲁门”号核动力航母(CVN-75)	ship
“哈里·杜鲁门”号航空母舰	ship
美国海军“哈里S。杜鲁门”号航空母舰(CVN 75)	ship
“杜鲁门”号航空母舰(CVN 75)	ship
CVN-75“哈里·杜鲁门”号航空母舰	ship
“杜鲁门”号航空母舰(USS Harry S. Truman CVN-75)	ship
美国海军杜鲁门号航空母舰	ship
美国海军CVN-75“杜鲁门”号航母	ship
美国“杜鲁门”号航母	ship
美国军舰“杜鲁门”号航母	ship
美国海军杜鲁门号核动力航母	ship
美国“杜鲁门”号核动力航母	ship
“哈利 S杜鲁门”号航母	ship
“杜鲁门号”航母	ship
“卡尔·文森”号	ship
“卡尔·文森”号航母	ship
“卡尔·文森”号航母战斗群	ship
美国海军CVN-70卡尔-文森号航母战斗群	ship
“卡尔·文森”号航母	ship
美国海军卡尔-文森号航母	ship
卡尔文森号	ship
“卡尔·文森”号航空母舰	ship
“卡尔-文森”号	ship
美国航母“卡尔·文森号”	ship
美国“卡尔·文森”号航母	ship
卡尔·文森号航母	ship
“卡尔·文森”号	ship
卡尔文森号航母	ship
“卡尔文森”号航母	ship
美国核动力航母“卡尔文森”号	ship
“文森”号航母	ship
CVN70“卡尔文森”号	ship
“卡尔-文森”号航母	ship
卡尔·文森号	ship
“卡尔文森”号	ship
核动力航母“卡尔·文森”号	ship
“卡尔文森”号航母战斗群	ship
美国核动力航空母舰“卡尔·文森”号战斗群	ship
美国“卡尔·文森”号航母	ship
“卡尔·文森号”核动力航母	ship
“卡尔·文森号”航母	ship
“卡尔·文森号”	ship
美航母“卡尔·文森”号	ship
美国海军“卡尔·文森”号核动力航母	ship
“卡尔·文森”号战斗群	ship
美国核动力航空母舰卡尔文森号	ship
卡尔.文森号核航母	ship
美国核动力航空母舰卡尔·文森号	ship
美国“卡尔·文森”号核动力航空母舰	ship
美国航母“卡尔文森”号	ship
美国航空母舰“卡尔文森”号	ship
美国核动力航母“卡尔·文森”号	ship
美军“卡尔·文森”号核动力航母	ship
美海军“卡尔·文森”号航母	ship
卡尔-文森号航母	ship
美国卡尔·文森号	ship
航母“卡尔·文森”号	ship
美军的“卡尔·文森”号航母	ship
美国“卡尔·文森”号核动力航母	ship
“卡尔·文森号”	ship
“卡尔·文森”号航空母舰(CVN 70)	ship
“卡尔·文森”号航母(CVN-70)	ship
美国海军CVN-70卡尔-文森号航母	ship
美国海军卡尔-文森号航空母舰	ship
美军“卡尔·文森”号航母	ship
‘卡尔·文森’号航母	ship
美国海军“卡尔·文森”号航母	ship
“卡尔-文森”号航母战斗群	ship
美“卡尔·文森”号航母	ship
美军卡尔·文森号航母	ship
“卡尔·文森”号(CVN-70)航母	ship
文森号航母	ship
文森号	ship
美国海军“卡尔·文森”号航空母舰	ship
美国“卡尔·文森”号核动力航母战斗群	ship
美国海军“卡尔·文森”号核动力航空母舰	ship
核动力航母“卡尔·文森”号战斗群	ship
美国海军“卡尔·文森”号航母战斗群	ship
美海军“卡尔·文森”号核航母	ship
卡尔文森号航空母舰	ship
美国卡尔-文森号航空母舰	ship
美国海军卡尔-文森号核航母	ship
美国海军核动力航空母舰“卡尔·文森”号	ship
美国“卡尔-文森”号核动力航母	ship
美国卡尔-文森号航母	ship
美军“卡尔-文森”号核航母	ship
“林肯”号	ship
“林肯”号航母	ship
林肯号	ship
“林肯”号航母战斗群	ship
林肯号航母	ship
“亚伯拉罕·林肯”号航母	ship
美国航空母舰“林肯号”	ship
美国海军CVN-72林肯号航母	ship
CVN72“林肯”号	ship
美国海军CVN-72林肯号核航母	ship
“林肯”号核动力航母	ship
“林肯号”	ship
“亚伯拉罕·林肯”号航母战斗群	ship
“亚伯拉罕·林肯”号核动力航母	ship
“亚拉伯罕·林肯”号	ship
航母“林肯”号	ship
林肯号航空母舰	ship
美国“林肯”号航母	ship
美国“林肯”号航母战斗群	ship
美国海军“林肯”号航空母舰战斗群	ship
美国海军“林肯”号航母战斗群	ship
美国海军“亚伯拉罕·林肯”号核动力航空母舰	ship
美国海军林肯号核动力航母	ship
“林肯”号(CVN 72)	ship
“林肯”号航空母舰	ship
“林肯”号核动力航母(CVN72)	ship
“林肯”号战斗群	ship
“林肯号”航空母舰	ship
“亚伯拉罕·林肯”号	ship
“亚伯拉罕·林肯”号航空母舰	ship
“亚伯拉罕·林肯”号航母(CVN 72)	ship
“亚伯拉罕·林肯”号航母编队	ship
“亚伯拉罕·林肯”号核动力航空母舰	ship
“亚伯拉罕·林肯”号核动力航母编队	ship
“亚伯拉罕·林肯号”航母	ship
“亚伯拉罕-林肯”号航母战斗群	ship
CVN72林肯号航母	ship
航母“亚伯拉罕·林肯”号	ship
林肯”号航母(CVN-72)	ship
林肯号航母战斗群	ship
美国“林肯”号	ship
美国“林肯号”航母	ship
美国“林肯号”核动力航母战斗群	ship
美国“亚伯拉罕·林肯”号核动力航母	ship
美国“亚伯拉罕·林肯”号核动力航母	ship
美国的“林肯”号	ship
美国海军“亚伯拉罕·林肯”号航空母舰	ship
美国海军“亚伯拉罕·林肯”号航母	ship
美国海军“亚伯拉罕-林肯”号航母	ship
美国海军林肯号航母	ship
美国海军林肯号航母战群	ship
美国航母“林肯号”	ship
美国林肯号航空母舰队	ship
美国林肯号航空母舰战斗群	ship
美国林肯号航母战斗群	ship
美海军“林肯”号航空母舰战斗群	ship
美军“林肯”号航母	ship
美军“林肯”号航母编队	ship
美军“林肯”号航母战斗群	ship
美军“林肯号”航母编队	ship
美军“林肯号”核动力航母战斗群	ship
美军的“亚伯拉罕·林肯”号航母	ship
美军林肯号航母	ship
尼米兹级核动力航空母舰“亚伯拉罕·林肯”号航母战斗群	ship
尼米兹级核动力航母“林肯”号	ship
“艾森豪威尔”号	ship
“艾森豪威尔”号航母	ship
"艾森豪威尔"号	ship
"艾森豪威尔"号航母	ship
艾森豪威尔号	ship
艾森豪威尔号航母	ship
“艾森豪威尔”号航母战斗群	ship
美国“艾森豪威尔”号航母战斗群	ship
CVN69“艾森豪威尔”号	ship
美军“艾森豪威尔”号航空母舰	ship
美国海军“艾森豪威尔”号航母	ship
美国“艾森豪威尔”号航母	ship
“艾森豪威尔号”	ship
“艾森豪威尔”号航空母舰	ship
尼米兹级航母“艾森豪威尔”号	ship
美军“艾森豪威尔”号航母	ship
美国海军艾森豪威尔号	ship
[CVN 69]	ship
美国海军“艾森豪威尔”号航空母舰	ship
美国“艾森豪威尔”号核动力航母	ship
美国“艾森豪威尔”号航空母舰	ship
德怀特·艾森豪威尔”号	ship
艾森豪威尔号航空母舰	ship
[艾森豪威尔号CVN-69]	ship
艾森豪威尔”号航母打击群(CSG)	ship
“德怀特·艾森豪威尔”号航母	ship
“艾森豪威尔”号核动力航母	ship
“艾森豪威尔”号航母打击群(CSG)	ship
“艾森豪威尔”号航母编队	ship
“艾森豪威尔”号航母	ship
[CVN 69]	ship
“艾森豪威尔”号航空母舰(USS Dwight D. Eisenhower CVN-69)	ship
“艾森豪威尔“号航母	ship
“布什”号	ship
“布什”号航母	ship
CVN77“布什”号	ship
布什号	ship
“华盛顿”号	ship
“华盛顿”号航母	ship
“乔治·华盛顿”号	ship
“华盛顿号”	ship
华盛顿号航母	ship
“乔治·华盛顿”号航母	ship
CVN73“华盛顿”号	ship
华盛顿号	ship
美国的“华盛顿”号	ship
“乔治·华盛顿”号	ship
“乔治？华盛顿”号	ship
“乔治·华盛顿”号航母战斗群	ship
“里根”号	ship
里根号	ship
CVN76“里根”号	ship
“里根”号航母	ship
核动力航母“罗纳德·里根”号	ship
“罗纳德·里根”号	ship
“罗纳德-里根”号	ship
美国“罗纳德·里根”号核动力航母	ship
里根”号核动力航母	ship
“里根”号航母(CVN-76)	ship
美国核动力航母“里根”号	ship
“罗纳德·里根”号航母战斗群	ship
“尼米兹”号	ship
“尼米兹”号航母	ship
CVN68“尼米兹”号	ship
尼米兹号航母	ship
航母“尼米兹号”	ship
“尼米兹”航母	ship
“尼米兹”号航母打击群	ship
美军尼米兹号航母(CVN 68)	ship
尼米兹号	ship
“斯坦尼斯”号	ship
斯坦尼斯号核航母	ship
斯坦尼斯号	ship
“斯坦尼斯”号航母战斗群	ship
“约翰·斯滕尼斯”号	ship
“约翰·斯坦尼斯”号航母	ship
“约翰·斯坦尼斯”号航母战斗群	ship
CVN74“斯坦尼斯”号	ship
“斯坦尼斯号”航母编队	ship
美国“约翰·斯滕尼斯”号航母战斗群	ship
“斯坦尼斯”号航母编队	ship
“约翰-斯坦尼斯”号	ship
航母“约翰·斯坦尼斯”号	ship
“约翰-斯坦尼斯”号航母战斗群	ship
“约翰·斯滕尼斯”号航母战斗群	ship
“约翰-斯坦尼斯”号航母	ship
“约翰·C·史坦尼斯”号航母	ship
‘斯坦尼斯’号航母战斗群	ship
美国的“斯坦尼斯”号航空母舰	ship
“斯坦尼斯”号航母	ship
“约翰·斯坦尼斯”号	ship
“约翰-斯滕尼斯”号	ship
约翰·斯坦尼斯号	ship
莫比尔湾号	ship
出发	event
起航	event
出港	move1
离开	event
撤出	event
途径	event
驶过	event
通过	event
抵达	event
到达	event
至	event
赶到	event
停留	event
停靠	event
访问	event
到访	event
返回	event
回到	event
前往	event
开赴	move5
开往	move5
驶向	event
急赴	move5
靠近	event
在	event
出现	event
军演	event
前往	event
神奈川县	ns
横须贺市	ns
神奈川		ns
横须贺		ns
驶离	event
驻扎	event
驶入	event
南海	ns
南中国海	ns
泰国湾	ns
北部湾	ns
台湾海峡	ns
东海	ns
渤海	ns
中国	ns
北京	ns
海淀	ns
日本	ns
黄海	ns
太平洋	ns
大西洋	ns
北冰洋	ns
印度洋	ns
西太平洋	ns
东太平洋	ns
阿拉弗拉海 	ns
峇里海 	ns
班达海 	ns
白令海 	ns
保和海	ns
卡莫特斯海	ns
西里伯斯海	ns
塞兰海	ns
智利海	ns
珊瑚海	ns
弗洛勒斯海	ns
阿拉斯加湾	ns
加利福尼亚湾	ns
卡奔塔利亚湾	ns
丰塞卡湾	ns
丰塞卡湾	ns
爪哇海	ns
科罗海	ns
望加锡海峡	ns
马鲁古海	ns
莫罗湾	ns
菲律宾海	ns
萨利希海	ns
萨武海	ns
鄂霍次克海	ns
濑户内海	ns
锡布延海	ns
所罗门海	ns
苏禄海	ns
塔斯曼海	ns
米沙鄢海	ns
亚得里亚海	ns
爱琴海	ns
阿尔沃兰海	ns
群岛海	ns
阿根廷海	ns
巴芬湾	ns
巴利阿里海	ns
比斯开湾	ns
波的尼亚海	ns
坎佩切湾	ns
芬迪湾	ns
黑海	ns
博滕海	ns
加勒比海	ns
凯尔特海	ns
戴维斯海峡	ns
英吉利海峡	ns
福克斯湾	ns
格陵兰海	ns
芬兰湾	ns
里昂湾	ns
几内亚湾	ns
缅因湾	ns
墨西哥湾	ns
圣罗伦斯湾	ns
委内瑞拉湾	ns
哈德森湾	ns
詹姆斯湾	ns
爱奥尼亚海	ns
爱尔兰海	ns
伊尔明厄海	ns
拉布拉多海	ns
累范特海	ns
利比亚海	ns
利古里亚海	ns
马尔马拉海	ns
地中海	ns
密耳提安海	ns
北海	ns
挪威海	ns
圣罗伦斯湾	ns
奥兰海	ns
亚速海	ns
克里特海	ns
赫布里底海	ns
色雷斯海	ns
第勒尼安海	ns
阿蒙森湾	ns
巴伦支海	ns
波弗特海	ns
白令海峡	ns
楚科奇海	ns
东西伯利亚海	ns
弗拉姆海峡	ns
布西亚湾	ns
喀拉海	ns
喀拉海峡	ns
拉普捷夫海	ns
林肯海	ns
古斯塔夫阿道夫王子海	ns
伯朝拉海	ns
万德海	ns
白海	ns
咸海	ns
里海	ns
死海	ns
索尔顿海	ns
南冰洋	ns
别林斯高晋海	ns
合作海	ns
宇航员海	ns
戴维斯海	ns
迪尔维尔海	ns
哈康七世国王海	ns
拉扎列夫海	ns
里塞-拉森海	ns
莫森海	ns
斯科舍海	ns
索莫夫海	ns
威德尔海	ns
安道尔	ns
亚拉巴马州	ns
Alabama	ns
阿拉斯加州	ns
Alaska	ns
亚利桑那州	ns
Arizona	ns
阿肯色州	ns
Arkansas	ns
加利福尼亚州	ns
California	ns
科罗拉多州	ns
Colorado	ns
康涅狄格州	ns
Connecticut	ns
特拉华州	ns
Delaware	ns
佛罗里达州	ns
Florida	ns
佐治亚州	ns
Georgia	ns
夏威夷州	ns
Hawaii	ns
爱达荷州	ns
Idaho	ns
伊利诺伊州	ns
Illinois	ns
印第安纳州	ns
Indiana	ns
爱荷华州	ns
Iowa	ns
堪萨斯州	ns
Kansas	ns
肯塔基州	ns
Kentucky	ns
路易斯安那州	ns
Louisiana	ns
缅因州	ns
Maine	ns
马里兰州	ns
Maryland	ns
马萨诸塞州	ns
Massachusetts	ns
密歇根州	ns
Michigan	ns
明尼苏达州	ns
Minnesota	ns
密西西比州	ns
Mississippi	ns
密苏里州	ns
Missouri	ns
蒙大拿州	ns
Montana	ns
内布拉斯加州	ns
Nebraska	ns
内华达州	ns
Nevada	ns
新罕布什尔州	ns
New Hampshire	ns
新泽西州	ns
New Jersey	ns
新墨西哥州	ns
New Mexico	ns
纽约州	ns
New York	ns
北卡罗来纳州	ns
North Carolina	ns
北达科他州	ns
North Dakota	ns
俄亥俄州	ns
Ohio	ns
俄克拉何马州	ns
Oklahoma	ns
俄勒冈州	ns
Oregon	ns
宾夕法尼亚州	ns
Pennsylvania	ns
罗得岛州	ns
Rhode Island	ns
南卡罗来纳州	ns
South Carolina	ns
南达科他州	ns
South Dakota	ns
田纳西州	ns
Tennessee	ns
得克萨斯州	ns
Texas	ns
犹他州	ns
Utah	ns
佛蒙特州	ns
Vermont	ns
弗吉尼亚州	ns
Virginia	ns
华盛顿州	ns
Washington	ns
西弗吉尼亚州	ns
West Virginia	ns
威斯康星州	ns
Wisconsin	ns
怀俄明州	ns
Wyoming	ns
华盛顿哥伦比亚特区	ns
华盛顿	ns
特区	ns
华府	ns
Washington D.C.	ns
Washington	ns
诺福克	ns
Norfolk	ns
圣迭戈县	ns
圣迭戈市	ns
City of San Diego	ns
杜瓦尔县	ns
杰克逊维尔	ns
Jacksonville	ns
檀香山市与县	ns
火奴鲁鲁市	ns
檀香山	ns
Honolulu	ns
美国东海岸	ns
美国西海岸	ns
中太平洋	ns
霍尔木兹海峡	ns
波斯湾	ns
东亚	ns
釜山港	ns
首尔特别市	ns
首尔市	ns
首尔	ns
汉城	ns
釜山广域市	ns
釜山市	ns
釜山	ns
大邱广域市	ns
仁川广域市	ns
光州广域市	ns
大田广域市	ns
蔚山广域市	ns
京畿道	ns
江原道	ns
忠清北道	ns
忠清南道	ns
全罗北道	ns
全罗南道	ns
庆尚北道	ns
庆尚南道	ns
济州特别自治道	ns
亚洲	ns
非洲	ns
北美洲	ns
南美洲	ns
欧洲	ns
南极洲	ns
大洋洲	ns
朝鲜半岛	ns
山东半岛	ns
山东	ns
海南	ns
海南省	ns
海南岛	ns
西沙群岛	ns
南沙群岛	ns
香港	ns
香港港	ns
神奈川县	ns
神奈川	ns
横须贺市	ns
横须贺	ns
横须贺港	ns
横须贺基地	ns
横须贺海军基地	ns
横须贺	ns
横须贺海军设施	ns
东京湾	ns
诺福克海军基地	ns
诺福克市	ns
圣迭戈海军基地	ns
梅波特海军基地	ns
珍珠港海军基地	ns
斯诺霍米什县	ns
埃弗里特	ns
埃弗里特海军基地	ns
永暑礁	ns
美济礁	ns
渚碧礁	ns
太平岛	ns
中业岛	ns
南威岛	ns
西礁	ns
东礁	ns
弹丸礁	ns
万安滩	ns
东沙群岛	ns
中沙群岛	ns
黄岩岛	ns
海防港	ns
岘港	ns
马尼拉港	ns
辽东湾	ns
渤海湾	ns
莱州湾	ns
渤海海峡	ns
庙岛群岛	ns
庙岛列岛	ns
菲律宾群岛	ns
Yellow Sea	ns
西海	ns
阿拉伯海	ns
阿拉伯湾	ns
阿曼湾	ns
阿拉梅达县	ns
阿拉梅达市	ns
阿拉梅达	ns
阿拉梅达港	ns
阿普拉港	ns
巴生港	ns
巴生	ns
马六甲海峡	ns
安达曼海	ns
班达亚齐港	ns
班达亚齐	ns
布雷默顿港	ns
五岛列岛	ns
长崎县	ns
朝鲜半岛西海岸	ns
冲绳	ns
冲绳县	ns
冲绳群岛	ns
大连港	ns
大连市	ns
辽宁省	ns
钓鱼岛	ns
台湾省	ns
东北亚	ns
东南亚	ns
苏比克湾	ns
苏比克湾海军基地	ns
中东	ns
巴勒斯坦	ns
中东地区	ns
红海	ns
亚丁湾	ns
永兴岛	ns
大屿山岛	ns
大屿山	ns
大濠岛	ns
亚齐省	ns
林查班港	ns
林查班	ns
中华人民共和国	ns
China	ns
Caspian Sea	ns
坦帕湾	ns
Tampa Bay	ns
Gulf of Oman	ns
Каспийское море	ns
Golfe dOman	ns
Persian Gulf	ns
卡特加特海	ns
Kattegat Sea	ns
斯卡格拉克海峡	ns
Skagerrak	ns
Gulf of Finland	ns
咸海 	ns
波罗的海	ns
Baltic Sea	ns
俄罗斯	ns
拉脱维亚	ns
波的尼亚湾	ns
Gulf of Bothnia	ns
孟加拉湾 	ns
Bay of Bengal	ns
Gulf of Thailand	ns
Makassar Strait	ns
Korea Strait	ns
朝鲜海峡	ns
鞑靼海峡	ns
Strait of Tartary	ns
Tatar Strait	ns
Tartar Strait	ns
Strait of Tartar	ns
Sea of Okhotsk	ns
Red Sea	ns
Caribbean Sea	ns
Chukchi Sea	ns
Gulf of Aden	ns
Java Sea	ns
Banda Sea	ns
Flores Sea	ns
Adriatic Sea	ns
Celtic Sea	ns
North Sea	ns
Tasman Sea	ns
Sea of Crete	ns
Philippine Sea	ns
Molukka sea	ns
摩鹿加海	ns
Ceram Sea	ns
Savu Sea	ns
Mediterranean Sea	ns
South China Sea	ns
哈马黑拉海	ns
Halmahera Sea	ns
萨马海	ns
Samar Sea	ns
Visayan Sea	ns
Bohol Sea	ns
Bering Sea	ns
Black Sea	ns
俾斯麦海	ns
Bismarck Sea	ns
Solomon Sea	ns
Coral Sea	ns
Greenland Sea	ns
马尾藻海 	ns
Sargasso Sea	ns
Scotia Sea	ns
Aegean Sea	ns
Marmara Sea	ns
Tyrrhenian Sea	ns
伊奥尼亚海	ns
Ionian Sea	ns
Irish Sea	ns
Norwegian Sea	ns
White Sea	ns
Kara Sea	ns
Celebes Sea	ns
Sulu Sea	ns
帝汶海	ns
Timor Sea	ns
Arafura Sea	ns
Ligurian Sea	ns
East China Sea	ns
Barents Sea	ns
Laptev Sea	ns
东西伯利亚海	ns
East Siberian Sea	ns
Arabian Sea	ns
Beaufort Sea	ns
Labrador Sea	ns
Davis Strait	ns
Sibuyan Sea	ns
Weddell Sea	ns
Bellingshausen Sea	ns
阿蒙森海	ns
Amundsen Sea	ns
罗斯海	ns
Ross Sea	ns
Azov Sea	ns
普伦蒂湾	ns
丰盛湾	ns
Bay of Plenty	ns
Ob Bay	ns
Long Bay	ns
切萨皮克湾	ns
Chesapeake Bay	ns
Chaleur Bay	ns
卡迪根湾	ns
Cardigan Bay	ns
昂斯洛湾	ns
Onslow Bay	ns
Bay of Biscay	ns
特拉华湾	ns
Delaware Bay	ns
科德角湾	ns
Cape Cod Bay	ns
White Bay	ns
Placentia Bay	ns
Fortune Bay	ns
圣母湾	ns
Notre Dame Bay	ns
巴芬湾	ns
Baffin Bay	ns
昂加瓦湾	ns
Ungava Bay	ns
彼得大帝湾	ns
Peter the Great Bay	ns
朝鲜湾	ns
Korea Bay	ns
Laizhou Bay	ns
马萨诸塞湾	ns
Massachusetts Bay	ns
布扎兹海湾	ns
Buzzards Bay	ns
Bay of Fundy	ns
Frobisher Bay	ns
Foxe Basin	ns
James Bay	ns
哈得逊湾	ns
Hudson Bay	ns
Committee Bay	ns
Mackenzie Bay	ns
奥美尼湾	ns
Ommanney Bay	ns
Bahia Sebastian Viscaino	ns
Rio de la Plata	ns
Bahia Grande	ns
卡斯科奎姆湾	ns
Kuskokwim Bay	ns
布里斯托尔湾	ns
Bristol Bay	ns
Gulf of Tonkin	ns
Gulf of Shelekov	ns
Gulf of California	ns
Gulf of Mexico	ns
Gulf of St. Lawrence	ns
里加湾	ns
Gulf of Riga	ns
锡德拉湾	ns
Gulf of Sidra	ns
Gulf of Alexandria	ns
Gulf of Taranto	ns
Gulf of Corinth	ns
Gulf of Patrai	ns
Gulf of Lions	ns
托米尼湾	ns
Gulf of Tomini	ns
热那亚湾	ns
Gulf of Genoa	ns
Gulf of Valencia	ns
巴布亚湾	ns
Gulf of Papua	ns
直隶湾	ns
Gulf of Chihli	ns
特万特佩克湾	ns
Gulf of Tehuantepec	ns
巴拿马湾	ns
Gulf of Panama	ns
洪都拉斯湾	ns
Gulf of Honduras	ns
Gulf of Boothia	ns
阿纳德尔湾	ns
Gulf of Anadyr	ns
Gulf of Tolo	ns
Amundsen Gulf	ns
Gulf of Guinea	ns
Gulfo de Guayaquil	ns
Gulfo de San Matias	ns
Gulfo San Jorge	ns
Gulf of Alaska	ns
Queen Maude Gulf	ns
Gulf of Bone	ns
达连湾	ns
Gulf of Darien	ns
Gulf of Venice	ns
苏伊士湾	ns
Gulf of Suez	ns
亚喀巴湾	ns
Gulf of Aqaba	ns
Karamata Strait	ns
库克海峡	ns
Cook Strait	ns
佛罗里达海峡	ns
Florida Strait	ns
Straits of Florida	ns
贝尔岛海峡	ns
Strait of Belle Isle	ns
加来海峡	ns
多佛尔海峡	ns
Strait of Dover	ns
诺森伯兰海峡	ns
Northumberland Strait	ns
直布罗陀海峡	ns
Strait of Gibraltar	ns
麻六甲海峡	ns
Strait of Malacca	ns
哈得孙海峡	ns
Hudson Strait	ns
巴斯海峡	ns
Bass Strait	ns
托雷斯海峡	ns
Torres Strait	ns
Taiwan Strait	ns
卡伯特海峡	ns
Cabot Strait	ns
富兰克林海峡	ns
Franklin Strait	ns
Rae Strait	ns
巴罗海峡	ns
Barrow Strait	ns
麦克卢尔海峡	ns
McClure Strait	ns
丹麦海峡	ns
Denmark Strait	ns
赫卡特海峡	ns
Hecate Strait	ns
麦哲伦海峡 	ns
Strait of Magellan	ns
德雷克海峡	ns
Drake Passage	ns
舍利科夫海峡	ns
Shelikof Strait	ns
威尔士亲王海峡	ns
Prince of Wales Strait	ns
多尔芬和尤宁海峡	ns
Dolphin and Union Strait	ns
Dense Strait	ns
维多利亚海峡	ns
Victoria Strait	ns
吕宋海峡	ns
Luzon Strait	ns
巴布·厄耳·曼德海峡	ns
Bab al Mandab	ns
Sicilian Channel	ns
圣乔治海峡	ns
English Channel	ns
布里斯托尔海峡	ns
Bristol Channel	ns
北海峡	ns
North Channel	ns
马耳他海峡	ns
Malta Channel	ns
尤卡坦海峡	ns
Yucatan Channel	ns
福克斯海峡	ns
Foxe Channel	ns
麦克林托克海峡	ns
McClintock Channel	ns
肯尼迪海峡	ns
Kennedy Channel	ns
莫桑比克海峡	ns
Mozambique Channel	ns
明奇海峡	ns
The Minch	ns
Bequia Channel	ns
Pacific Ocean	ns
Bering Strait	ns
日本海	ns
东海	ns
Sea of Japan	ns
日本群岛	ns
台湾岛	ns
印度尼西亚群岛	ns
新几内亚岛	ns
济州海峡	ns
库页岛	ns
Сахалин	ns
萨哈林岛 	ns
Sakhalin	ns
樺太	ns
间宫海峡	ns
涅维尔斯科依海峡	ns
宗谷海峡	ns
Soya-Kaikyo 	ns
拉彼鲁兹海峡 	ns
北海道	ns
ほっかいどう	ns
北海道	ns
宗谷岬	ns
日本列島	ns
日本列岛	ns
四国	ns
九州	ns
本州	ns
津轻海峡	ns
大韩海峡	ns
济州岛	ns
巨济岛	ns
对马岛	ns
壹岐岛	ns
福江岛	ns
对马海峡	ns
南西诸岛	ns
琉球	ns
大隅群岛	ns
吐噶喇群岛	ns
宫古群岛	ns
奄美群岛	ns
八重山群岛	ns
维蒂亚兹海峡	ns
Vitiaz Strait	ns
勇士号海峡	ns
棉兰老海	ns
苏里高海峡	ns
苏拉威西海	ns
尖阁诸岛	ns
从	move1
起航	move1
出发	move1
出港	move1
向	move5
启程	move1
在	move1
抵达	move5
离开	move1
离港	move1
入港	move3
起锚	move1
进驻	move1
驶出	move1
驶离	move1
穿越	move2
穿过	move2
经过	move2
途径	move2
通过	move2
驶过	move2
停靠	move3
入港	move3
入驻	move3
出征	move5
到	move3
到访	move3
到达	move3
前往	move5
加入	move3
参加	move3
回到	move3
在	move3
奔赴	move5
开入	move3
开往	move3
开至	move3
开赴	move3
急赴	move3
折返	move3
抵	move3
抵达	move3
派出	move3
派往	move5
移至	move3
至	move3
访问	move3
赴	move5
赶到	move3
赶往	move3
赶赴	move5
返回	move3
返港	move3
回港	move3
进入	move3
进驻	move3
造访	move3
部署至	move3
部署到	move3
靠岸	move3
靠近	move3
驶入	move3
驶向	move5
驶往	move5
驶抵	move3
驶来	move3
驶进	move3
驻扎	move3
驻扎在	move3
亮相	move4
位于	move4
停靠	move4
同现	move4
在	move4
正在	move4
现身	move4
军演	event
驶向	move3
转战	move4
派出	event
西北太平洋	ns
硫磺岛	ns
仙台	ns
海湾	ns
阿拉伯海	ns
日本海	ns
亚太地区	ns
东亚	ns
樟宜	ns
参与	move4
经停	move4
穿行	move2
出征	move5
奔向	move5
母港	ns
驻日美海军横须贺基地	jidi
驻日美军横须贺基地	jidi
美国海军横须贺基地	jidi
美驻日海军横须贺基地	jidi
日本横须贺美军基地	jidi
美海军横须贺基地	jidi
驻日美军基地	jidi
横须贺港口	ns
 特种作战部	ship
 火奴鲁鲁号	ship
 温斯顿·丘吉尔号	ship
 海狼号	ship
 海曼·G·里科弗号	ship
 海军预备队	ship
 海伦娜号	ship
 洛杉矶号	ship
 波特号	ship
 波士顿号	ship
 法拉格特号	ship
 沙利文号	ship
 沙利文号	ship
 汉普顿号	ship
 水原空军基地	jidi
 水原基地	jidi
 水原	jidi
 横须贺港	jidi
 横须贺海军基地	jidi
 横须贺基地	jidi
 梅波特海军基地	jidi
 梅森号	ship
 桑普森号	ship
 格雷夫利号	ship
 格里德利号	ship
 格罗顿号	ship
 格罗顿号	ship
 格林维尔号	ship
 栗谷李珥号	ship
 柯蒂斯·威尔伯号	ship
 查菲号	ship
 杰斐逊城号	ship
 杰克逊维尔号	ship
 杨万春号	ship
 杜威号	ship
 朴次茅斯号	ship
 本福尔德号	ship
 木浦海军基地	ship
 木浦基地	ship
 普雷贝尔号	ship
 普罗维登斯号	ship
 普林斯顿号	ship
 明尼阿波利斯号	ship
 明尼苏达号	ship
 旧金山号	ship
 日本自卫队	ship
 日本自卫队	ship
 日本海军	ship
 日本海上自卫队	ship
 日本海上自卫队	ship
 日本军队	ship
 日本	nsf
 日本	nsf
 新罕布什尔号	ship
 新墨西哥号	ship
 斯特雷特号	ship
 斯普鲁恩斯号	ship
 斯普林菲尔德号	ship
 斯托特号	ship
 斯克兰顿号	ship
 文武大王号	ship
 文森斯号	ship
 提康德罗加号	ship
 拉霍亚号	ship
 拉森号	ship
 拉梅奇号	ship
 拉布恩号	ship
 拉塞尔号	ship
 托马斯·盖茨号	ship
 托莱多号	ship
 托皮卡号	ship
 怀俄明号	ship
 忠武公李舜臣号	ship
 德怀特·D·艾森豪威尔号	ship
 德克萨斯号	ship
 张伯伦湖号	ship
 弗吉尼亚号	ship
 康涅狄格号	ship
 广开土大王号	ship
 平泽海军基地	ship
 平泽基地	ship
 平克尼号	ship
 帕萨迪纳号	ship
 希金斯号	ship
 希洛号	ship
 布雷默顿号	ship
 布法罗号	ship
 布什号	ship
 巴里号	ship
 巴尔的摩号	ship
 巴尔克利号	ship
 巴吞鲁日号	ship
 巴丹号	ship
 崔莹号	ship
 尼采号	ship
 尼米兹号	ship
 密西西比号	ship
 密苏里号	ship
 密歇根号	ship
 宾夕法尼亚号	ship
 安齐奥号	ship
 安纳波利斯号	ship
 安提坦号	ship
 孟菲斯号	ship
 威廉·P·劳伦斯号	ship
 姜邯赞号	ship
 奥马哈号	ship
 奥林匹亚号	ship
 奥斯卡·奥斯汀号	ship
 奥尔巴尼号	ship
 奥古斯塔号	ship
 奥凯恩号	ship
 太平洋舰队	ship
 大邱空军基地	ship
 大邱基地	ship
 大祚荣号	ship
 夏洛特号	ship
 夏延号	ship
 夏威夷号	ship
 基韦斯特号	ship
 基萨奇号	ship
 基德号	ship
 埃弗里特海军基地	ship
 埃塞克斯号	ship
 圣迭戈海军基地	ship
 圣菲号	ship
 圣胡安号	ship
 圣哈辛托号	ship
 圣乔治角号	ship
 图森号	ship
 唐纳德·库克号	ship
 哥伦比亚号	ship
 哥伦布号	ship
 哈特福德号	ship
 哈尔西号	ship
 哈利·S·杜鲁门号	ship
 吉米·卡特号	ship
 吉米·卡特	ship
 吉塞普海军基地	ship
 史托戴尔号	ship
 史塔森号	ship
 厚木海军基地	ship
 印第安纳波利斯号	ship
 卡尼号	ship
 卡尔·文森号	ship
 博诺姆·理查德号	ship
 博克瑟号	ship
 博伊西号	ship
 华盛顿号	ship
 华城空军基地	ship
 华城基地	ship
 匹兹堡号	ship
 北达科塔号	ship
 北卡罗来纳号	ship
 加利福尼亚号	ship
 切斯劳维尔号	ship
 军事海运司令部	ship
 冈萨雷斯号	ship
 内布拉斯加号	ship
 内华达号	ship
 光州空军基地	ship
 光州基地	ship
 保罗·汉密尔顿号	ship
 俄克拉荷马号	ship
 俄亥俄号	ship
 作战测试与评估部	ship
 佛罗里达号	ship
 佐治亚号	ship
 伯明翰号	ship
 休斯敦号	ship
 伊利湖号	ship
 亨利·杰克逊号	ship
 亚特兰大号	ship
 亚历山德里亚号	ship
 亚伯拉罕·林肯号	ship
 乙支文徳号	ship
 乔辛号	ship
 乔治·华盛顿号	ship
 乔治·H·W·布什号	ship
 乌山空军基地	ship
 乌山基地	ship
 乌山	ship
 中央司令部	ship
 东海海军基地	ship
 东海基地	ship
 世宗大王号	ship
 “达拉斯”号	ship
 Yorktown	ship
 Yang manchun	ship
 WASP	ship
 Wang Gun	ship
 Virginia	ship
 Vincennes	ship
 Vicksburg	ship
 Vella Gulf	ship
 Valley Forge	ship
 USS Theodore Roosevelt	ship
 USS Ronald Reagan	ship
 USS Nimitz	ship
 USS John C. Stennis	ship
 USS Harry S. Truman	ship
 USS George Washington	ship
 USS George H.W. Bush 	ship
 USS Dwight D. Eisenhower	ship
 USS Carl Vinson	ship
 USS Abraham Lincoln	ship
 USN	ship
 United States Navy	ship
 Ulchimundok	ship
 U.S. Navy	ship
 Tucson	ship
 Topeka	ship
 Toledo	ship
 Ticonderoga	ship
 Thomas S. Gates	ship
 Texas	ship
 SSN772	ship
 SSN768	ship
 SSN766	ship
 SSN705	ship
 SSN690	ship
 SSN689	ship
 SSN688	ship
 SSN-785	ship
 SSN-784	ship
 SSN-783	ship
 SSN-782	ship
 SSN-781	ship
 SSN-780	ship
 SSN-779	ship
 SSN-778	ship
 SSN-777	ship
 SSN-776	ship
 SSN-775	ship
 SSN-774	ship
 SSN-773	ship
 SSN-771	ship
 SSN-770	ship
 SSN-769	ship
 SSN-767	ship
 SSN-766	ship
 SSN-765	ship
 SSN-764	ship
 SSN-763	ship
 SSN-762	ship
 SSN-761	ship
 SSN-760	ship
 SSN-759	ship
 SSN-758	ship
 SSN-757	ship
 SSN-756	ship
 SSN-755	ship
 SSN-754	ship
 SSN-753	ship
 SSN-752	ship
 SSN-751	ship
 SSN-750	ship
 SSN-725	ship
 SSN-724	ship
 SSN-723	ship
 SSN-722	ship
 SSN-721	ship
 SSN-720	ship
 SSN-719	ship
 SSN-718	ship
 SSN-717	ship
 SSN-716	ship
 SSN-715	ship
 SSN-714	ship
 SSN-713	ship
 SSN-712	ship
 SSN-711	ship
 SSN-710	ship
 SSN-709	ship
 SSN-708	ship
 SSN-707	ship
 SSN-706	ship
 SSN-705	ship
 SSN-704	ship
 SSN-703	ship
 SSN-702	ship
 SSN-701	ship
 SSN-700	ship
 SSN-699	ship
 SSN-698	ship
 SSN-697	ship
 SSN-696	ship
 SSN-695	ship
 SSN-694	ship
 SSN-693	ship
 SSN-692	ship
 SSN-691	ship
 SSN-690	ship
 SSN-689	ship
 SSN-688	ship
 SSN-23	ship
 SSN-22	ship
 SSN-21	ship
 SSGN-729	ship
 SSGN-728	ship
 SSGN-727	ship
 SSGN-726	ship
 SSBN-743	ship
 SSBN-742	ship
 SSBN-741	ship
 SSBN-740	ship
 SSBN-739	ship
 SSBN-738	ship
 SSBN-737	ship
 SSBN-736	ship
 SSBN-735	ship
 SSBN-734	ship
 SSBN-733	ship
 SSBN-732	ship
 SSBN-731	ship
 SSBN-730	ship
 Springfield	ship
 Shiloh	ship
 Seawolf	ship
 Scranton	ship
 Santa Fe	ship
 San Juan	ship
 San Jacinto	ship
 San Francisco	ship
 Salt Lake City	ship
 Providence	ship
 Princeton	ship
 Portsmouth	ship
 Port Royal	ship
 Pittsburgh	ship
 Phoenix	ship
 Philippine Sea	ship
 Philadelphia	ship
 Pasadena	ship
 Omaha	ship
 Olympia	ship
 Oklahoma	ship
 NS Norfolk	ship
 North Dakota	ship
 North Carolina	ship
 Normandy	ship
 Norfolk Naval Base	ship
 Norfolk	ship
 Newport News	ship
 New York City	ship
 New Mexico	ship
 New Hampshire	ship
 Naval Station Norfolk	ship
 Munmu the Great	ship
 Montpellier	ship
 Monterey	ship
 Mobile Bay	ship
 Missouri	ship
 Mississippi	ship
 Minnesota	ship
 Minneapolis-Saint Paul	ship
 Miami	ship
 Memphis	ship
 Makin Island	ship
 Louisville	ship
 Los Angeles	ship
 LHD-8 Makin Island	ship
 LHD-8	ship
 LHD-7	ship
 LHD-6	ship
 LHD-5	ship
 LHD-4	ship
 LHD-3	ship
 LHD-2	ship
 LHD-1	ship
 Leyte Gulf	ship
 Lake Erie	ship
 Lake Champlain	ship
 La Jolla	ship
 Kwanggaeto the Great	ship
 Key West	ship
 KEARSARGE	ship
 John Warnar	ship
 Jimmy Carter	ship
 Jefferson City	ship
 Jacksonville	ship
 IWO JIMA	ship
 Indianapolis	ship
 Hyman G. Rickover	ship
 Hue City	ship
 Houston	ship
 Honolulu	ship
 Helena	ship
 Hawa II	ship
 Hartford	ship
 Hampton	ship
 Groton	ship
 Greenville	ship
 Gettysburg	ship
 Gang Gamchan	ship
 ESSEX	ship
 Dokdo amphibious assault ship	ship
 DDH-973	ship
 DDH-972	ship
 DDH-971	ship
 DDH 981	ship
 DDH 979	ship
 DDH 978	ship
 DDH 977	ship
 DDH 976	ship
 DDH 975	ship
 DDG-993	ship
 DDG-992	ship
 DDG-991	ship
 DDG-99	ship
 DDG-98	ship
 DDG-97	ship
 DDG-96	ship
 DDG-95	ship
 DDG-94	ship
 DDG-93	ship
 DDG-92	ship
 DDG-91	ship
 DDG-90	ship
 DDG-89	ship
 DDG-88	ship
 DDG-87	ship
 DDG-86	ship
 DDG-85	ship
 DDG-84	ship
 DDG-83	ship
 DDG-82	ship
 DDG-81	ship
 DDG-80	ship
 DDG-79	ship
 DDG-78	ship
 DDG-77	ship
 DDG-76	ship
 DDG-75	ship
 DDG-74	ship
 DDG-73	ship
 DDG-72	ship
 DDG-71	ship
 DDG-70	ship
 DDG-69	ship
 DDG-68	ship
 DDG-67	ship
 DDG-66	ship
 DDG-65	ship
 DDG-64	ship
 DDG-63	ship
 DDG-62	ship
 DDG-61	ship
 DDG-60	ship
 DDG-59	ship
 DDG-58	ship
 DDG-57	ship
 DDG-56	ship
 DDG-55	ship
 DDG-54	ship
 DDG-53	ship
 DDG-52	ship
 DDG-51	ship
 DDG-112	ship
 DDG-111	ship
 DDG-110	ship
 DDG-109	ship
 DDG-108	ship
 DDG-107	ship
 DDG-106	ship
 DDG-105	ship
 DDG-104	ship
 DDG-103	ship
 DDG-102	ship
 DDG-101	ship
 DDG-100	ship
 Dallas	ship
 Daejoyoung	ship
 CVN-77	ship
 CVN-76	ship
 CVN-75	ship
 CVN-74	ship
 CVN-73	ship
 CVN-72	ship
 CVN-71	ship
 CVN-70	ship
 CVN-69	ship
 CVN-68	ship
 CTF-70	ship
 CSG-5	ship
 Cowpens	ship
 Corpus Christi	ship
 Connecticut	ship
 Commander	ship
 Columbus	ship
 Columbia	ship
 Cincinnati	ship
 Chosin	ship
 Choongmoogong Yi Soon Shin	ship
 Chicago	ship
 Cheyenne	ship
 Charlotte	ship
 Chancellorsville	ship
 Chae Yeon	ship
 CG-73	ship
 CG-72	ship
 CG-71	ship
 CG-70	ship
 CG-69	ship
 CG-68	ship
 CG-67	ship
 CG-66	ship
 CG-65	ship
 CG-64	ship
 CG-63	ship
 CG-62	ship
 CG-61	ship
 CG-60	ship
 CG-59	ship
 CG-58	ship
 CG-57	ship
 CG-56	ship
 CG-55	ship
 CG-54	ship
 CG-53	ship
 CG-52	ship
 CG-51	ship
 CG-50	ship
 CG-49	ship
 CG-48	ship
 CG-47	ship
 Cape St. George	ship
 California	ship
 Bunker Hill	ship
 Buffalo	ship
 Bremerton	ship
 BOXER	ship
 Boston	ship
 BONHOMME RICHARD	ship
 Boise	ship
 Birmingham	ship
 Baton Rouge	ship
 BATAAN	ship
 Baltimore	ship
 August	ship
 Atlanta	ship
 Asheville	ship
 Anzio	ship
 Antietam	ship
 Annapolis	ship
 Alexandria	ship
 Albuquerque	ship
 Albany	ship
